7 0 5 0 0
11 0 5 9 0	
15 2 5 4 1   
17 0 2 5 3
18 0 0 7 1	
20 7 3 5 2
23 6 0 2 0
35 4 5 3 1
40 3 5 5 3   
45 0 5 8 3
50 2 4 0 0
63 3 9 3 0 
70 5 1 1 1
95 5 1 9 3 
109 8 5 1 1
123 3 2 0 0
127 3 2 9 0
131 0 1 7 0
132 2 3 9 0
133 6 0 2 0
141 0 1 4 2
145 0 0 6 1 
148 4 0 5 1
161 0 4 4 2
173 7 1 9 0
193 1 5 1 2
194 1 3 1 2 
195 3 5 2 1
197 3 5 7 3
198 5 1 8 3
199 2 1 5 2
200 1 4 6 2
201 0 4 0 0
202 7 0 1 0
203 1 1 1 1
*